2 13 31
###############################
#p * *        *  ** * *      *#
# # # # #*# # #*# # # # # #*# #
#    * * *** **      *    **  #
# #*# # # # #1# #b#1# # # # #*#
#          *     **      *  **#
# # #*# # # # # #*#*#*#*# # # #
#   *        *   * *x* *      #
# # # # #*# # # # # # #*# #*# #
#  2****         *1           #
# # # # # # # # # #*# # # # #*#
#  ** *   *    3              #
###############################